#############
#..######..##
#.B.........#
#T.#######..#
#@.#######.##
##########.##
#...######..#
#...........#
#...#####..##
#############