#########
#..T@B..#
#.#####.#
#.......#
#########