##################################################
#.....................................#..........#
#......B...############...............#.#........#
#...##..........###............####...#.....##...#
#.....................................#.#........#
#..############################..##########.######
#............................#...................#
#............................#...................#
#...#######...#...########...#...................#
#.........#...#...#..........#..............T....#
#.........#...#...#..........#...................#
#.........#...#...#..........#...................#
#.........#...#...#..........#...................#
#.........#...#...#..........#...................#
#####.....#...#...#..........#...................#
#.........#...#...#...########...................#
#.........#...#...#..........#...................#
#.........#...#...#.####.....#...................#
#....######...#...#..........#...................#
#.........#########..........#...................#
#............................#...................#
#............................#.########..#######.#
##########################...#...######..........#
#............................#.....##..###.......#
#............#########.......#.....@.............#
#....#################.......#..........#####....#
#..............###########...#######....###......#
#.......##.......................................#
#............................#...................#
##################################################