########
#@.....#
#####..#
#......#
#......#
#..#####
#...B..#
#.T....#
########